NO wallnorth.png
SO wallsouth.png
WE wallwest.png
EA walleast.png
F 1,011,011
C 255,255,255,
11111111111111111111111111111111111111111111111111111111111
100000000000000000000000000000001111111111111111111111111111
1100000000000000000000000000000000000011111111111111111
1111110000000000000000111000000000000000000011111111111111111
11111000000000000111111111111100000000000000111111111111111
11110000000000011111111111111111100000000000111111111111111
11100000000001111111111111111111111100000001111111111111111
11000000000111111111111111111111111111000010111111111111111
10000000011111111111111111111111111111111111011111111111111
100000001111111111111111100001111111111111111101111111111111
100000011111111111111111100000011111111111111111111111111111
100000011111111111111111011111111111111111111110111111111111
100000011111111111111111100000011110001111111110111111111111
100000011111111111111111000000001111110111110000011111111111
100000000111111111111110000000000111110111100000001111111111
100000000000001111111100000000000011101111000000000111111111
100000000000000000001000000111100011111110011111000111111111
10000000000000000001100011110011111111101111111111111111111
100000000000000001111011110011001111111000011110111111111111
100000000000000011111011101111110111110111100111111111111111
10000000000000011111111011111111011111111111001111111111111
11000111000000011111111000000000000110000000000111111111111
10111111111000011111111011100000111110110000011111111111111
101100111111110011111111011110000111110111000111111000111111
11111000001111N11111110000000001111111011100010000111000111
11111000110011111111111111111100111111100000001111111111011
11110111111111111111111111111111111001111111111111111111011
11111111111111111110011111111111111110111111111111111111011
101111111111101111100000000001111111111000111111111111100111
10000111000011111111110001000000000000000000000000000011111
11111000111011111111111110010000000000000000001111111111111
11111111111100111111111011100000000000000000011111111111111
11111111111111000000000000111111111111111110111111111111111
111111111111111111111111110000000000000000011111111111111111
111111111111111111111111111111111111111111111111111111111111