NO wallnorth.png
SO wallsouth.png
WE wallwest.png
EA walleast.png
F 0,100,100
C 255,255,255,










111111111111111111111111111111111
0000000000000000000000000000000
111111111111111111111111111111111
10000000000000100000000000011
10000000000000000000000000001
1000000000000N000000000000001
10000000000000000000000000001
10000000000000000001010000001
11000001110101011111011110101
11110111 1110111 101111010001
11111111 1111111 111111111111
11111111111111
