11111111111111111111111111
1111100000110000000000001
10110000W11100000000000011
100100000000000000000000111111111
111111111011000001110000000000001
100000000011000001110111111111111
11110111111111011100000010001
10000000000110111010100100011
10000001110001011100000010001
1000000110000011000001000111
1000001111000001101010010001
110000011101010111110111100111
1111011111101011011110100011
1111111111111111111111111111

111110
1000010000
111111