NO ./wall1.png
SO ./wall2.png
WE ./wall3.png
EA                                           ./wall4.png
F 220,100,0
C        225,30,0





1111111111111111111111111
1000000000110000000000001
1011000001110000000000111  111  111111
100100000000000000000011111111101
111111111011000001110000000000001
100000000011000001110111111111111
11110111111111011100000010001
11110111111111011101010010001
11000000110101011100000010001
10000000000000001100W00010001
10000000000000001101010010001
110000011101010111110111100111
111101111110101101111010001001
111111111111111111111111111111