NO textures/bluestone.png
EA textures/wood.png
SO textures/greystone.png
WE textures/redbrick.png
F 110,30,20
C 255,255,0

11111111111111111111111111
10000000000000000000000001
10000000000000000000000011
1000000000000000000000001
1000000000000000000000001
1000000000000000000000001
10000000000N0000001000001
1000000000000000000000001
1000000000000000000000001
1000000000010000000000001
1000000000000000000000001
1000000000000000000000001
1111111111111111111111111
