NO ./wall1.png
SO ./wall2.png
WE ./wall3.png
EA                                           ./wall4.png
F 220,100,0
C 225,30,0

1111111111111111111111111
1000000000000000000000001
1000010000000000000000011
100001000000000000000001
1000010000000000000000011
1111111110110000011100001
10000000001100N00111011111
11110111111111011100000011
1000000000000000000000011
100000000000000000000001
11111111111111111111111111
