NO wallnorth.png
SO wallsouth.png
WE wallwest.png

EA walleast.png

F 0,0,0


C 255,255,150

1111111111111
1000000000001
1000000000001
1000001000001
1000000000001
110000E000001
1000000000001
1000000000001
1000000000001
1000101010001
1111111111111
