NO wallnorth.png
SO wallsouth.png

WE wallwest.png
EA walleast.png


F 0,0,0


C 255,255,150

11111111111111
10000000000001
10010100000011
10010000000001
11101101101111
10001000100011
100100N0000101
10001001001101
10000000000101
10000000000101
10000000000001
11111111111111
