NO textures/bluestone.png
SO textures/greystone.png
WE textures/redbrick.png
EA textures/wood.png
F 110,30,20
C 255,255,0

   


1111111111111111111111111
1000000000110000000000001
1011000001110000000000001
10010000000000000000000011111111111
111111111011000001110000000000001
100000000011000001110111111111111
1111011111111101110000000001
1111011111111101110101000001
1100000011010101110000000001
1000000000000000110000000001
10000000000000001101010000011
11000001110101011111011110N0111
11110111 1110101 101111010001
00011100000111110000001111111
11111111 1111111 111111111111
