NO textures/bluestone.png
SO textures/greystone.png
WE textures/redbrick.png
EA textures/wood.png
F 0,30,0
C 255,255,150

1111111111111
1000000000001
1000000000001
1000001000001
1000000000001
110000N000001
1000000000001
1000000000001
1000000000001
1000101010001
1111111111111
