NO wallnorth.png
SO wallsouth.png
WE wallwest.png
EA walleast.png

F 0,0,0


C 255,255,150

11111111111111
10000000000001
10000000000011
10000000000001
111111011111111
10000000000001
100000N0000001
10000000000001
10000000000001
10000000000001
10000000000001
11111111111111
