NO ./wall1.png
SO ./wall2.png
WE ./wall3.png
EA ./wall4.png
F 220,100,0
C 225,30,0

11111111111111
10000000000001
10010001000001
10010010001001
10110010001001
10100000001001
10000N00000001
10110001001001
10000010000001
10000000010001
11111111111111
