NO textures/bluestone.png
SO textures/greystone.png
WE textures/redbrick.png
EA textures/wood.png
F 0,30,0
C 255,255,150

11111111111
10000000001
10000000001
10000100001
10000000001
11000N00001
10000000001
10000000001
10000000001
10001010101
11111111111
