NO ./wall1.png
SO ./wall2.png
WE ./wall3.png
EA ./wall4.png
F 220,100,0
C 225,30,0

1111111111111
1000000000001
1000000000001
1000010100001
1000010100001
100000N000001
1000000000001
1000000000001
1000000000001
1111111111111
