NO ./wall1.png
SO ./wall2.png
WE ./wall3.png
EA ./wall4.png
F 220,100,0
C 225,30,0

11111111
10000001
10001001
10000001
101N1001
10010001
11111111
